######
#.S..#
#..#.#
#.#..#
#..T.#
######