###############################################################
#S.......#......#.......#..........#.............#......#.....#
#.#####.#.#.##.#.#.####.#.######.###.#.########.#.#.##.#.#.####
#.....#.#...#..#.......#........#...#.#........#.#..#.#.#...#.#
#####.#.#####.###.#####.#########.###.#.######.#.##.#.#.###.#.#
#.....#.....#.#.....................#.#.#....#.#..#...#.....#.#
#.#########.#.#.###.#####.###########.#.#.##.#.##...#.#####.#.#
#.........#.#.....#.....#.................#..#....#.#.......#.#
#######.#.#.#.###.#####.#.#.###############.######.#####.#.#.##
#.......#.#.......#.....#.#.............#...#....#.....#.#...##
#.#######.#.#####.#.#####.#############.#.###.#######.#.#.#.#.#
#...........#.....#...................#.....#........#...#T..##
###############################################################
