################################
#S..#.....#.....#.............##
##....#.###.#.#.#####.#.###.#..#
#...#.#.....#.#...........#...##
#.#####.#####.###.#.#.#.#.#.####
#...........#.#...#...#.#.....##
#..######.#.#.#T#.###.#.#####..#
#.#...#.#.#.#.#...#...#.#...#.##
#.#.#.#.#.....###...###.#.###.##
#...#.....#...#.....#...#.....##
##.###################.######.##
################################
