################################
#S......#.........#.....#.....##
#######.#.#######.#.###.#.#.#.##
#...#...#...#...#.#.#...#.#.#.##
#.#.#.#####.###...#.#.###.#...##
#.#.......#.....#...#.....#.#.##
##..#####.#T#####..######.#.#.##
#.......#.#.#...#.......#...#.##
#.###.###.##..#.#.#####.#.###.##
#...#.........#...#.......#...##
#########.#.########.###########
################################
