##########
#.S......#
#...#..#.#
#.##..####
#..#...T.#
##########